1948 Summer Olympics -> event, 
2001 Mars Odyssey -> spacecraft, ballistic_capsule, space_vehicle, 
2002 FIFA World Cup -> World_Cup, 
A Scanner Darkly -> award, awarding, 
Abner Doubleday -> army_officer, 
Abzyme -> monoclonal_antibody, monoclonal, 
Achduart -> hamlet, crossroads, 
Adams County, Iowa -> county, 
Adjacent-channel interference -> intervention, interference, 
Adrian Lamo -> analyst, 
Aegadian Islands -> island, 
Agathocles of Syracuse -> Syracuse, siege_of_Syracuse, 
Albanians -> state, nation, country, land, commonwealth, res_publica, body_politic, 
Albert Sidney Johnston -> career, calling, vocation, 
All Quiet on the Western Front -> novel, 
Alypius of Antioch -> geographer, 
Amazing Grace -> hymn, anthem, 
American National Standards Institute -> organization, organisation, 
Amorphous solid -> crystal, 
Anti-Ballistic Missile Treaty -> treaty, pact, accord, 
Armoured fighting vehicle -> fomite, vehicle, 
Arsenal F.C. -> clubhouse, club, 
Aryan Nations -> organization, organisation, 
Asunción -> capital, working_capital, 
Atari Jaguar -> computer_game, video_game, 
August Wilhelm Ambros -> composer, 
Australian Capital Territory -> state, nation, country, land, commonwealth, res_publica, body_politic, 
Austro-Asiatic languages -> Southeast_Asia, 
Axel Oxenstierna -> statesman, solon, national_leader, 
Azad Kashmir -> political_unit, political_entity, 
BQP -> problem, 
Backnang -> town, 
Ballsbridge -> railway_station, railroad_station, railroad_terminal, train_station, train_depot, 
Bedrock Records -> label, recording_label, 
Bell Labs -> alcatel-lucent (not found in WordNet)
Biconditional introduction -> inference, illation, 
Biomass (ecology) -> Mass, 
Biproduct -> product, mathematical_product, 
Carmilla -> novellum (not found in WordNet)
Central Committee of the Communist Party of the Soviet Union -> Communist_Party, 
Charlotte Amalie, United States Virgin Islands -> capital, working_capital, 
Chernobyl (city) -> city, metropolis, urban_center, 
Chhattisgarh -> state, province, 
Christiaan Barnard -> surgeon, operating_surgeon, sawbones, 
Christian Democratic Union (Germany) -> party, political_party, 
Chymotrypsin -> enzyme, 
Cinema of the United Kingdom -> influence, 
Circumcision and law -> law, law_of_nature, 
Clay County -> county, 
Clay County, Illinois -> county, 
Colonna family -> family, family_line, folk, kinfolk, kinsfolk, sept, phratry, 
Combat-net radio -> radio, wireless, 
Common battery -> source, 
Constantin Brâncuşi -> sculptor, sculpturer, carver, statue_maker, 
Context switch -> process, unconscious_process, 
Corfu -> island, 
Cosmological argument -> argument, argumentation, debate, 
Cuboctahedron -> polyhedron, 
Cypherpunk anonymous remailer -> remailer (not found in WordNet)
DATR -> language, linguistic_communication, 
Dave Mattacks -> drummer, 
David Jason -> actor, doer, worker, 
Demographics of India -> country, rural_area, 
Diego Maradona -> football_player, footballer, 
Digital Visual Interface -> standard, criterion, measure, touchstone, 
Direct-sequence spread spectrum -> technique, 
Disraeli (film) -> film, 
Double Cross System -> anti-espionage (not found in WordNet)
Dyson's eternal intelligence -> concept, conception, construct, 
Economy of Malta -> limestone, 
Economy of Zambia -> country, rural_area, 
Edmund Clerihew Bentley -> novelist, 
Edward Mitchell Bannister -> painter, 
Enid Blyton -> writer, author, 
European Convention on Human Rights -> treaty, pact, accord, 
European Democrats -> party, political_party, 
European Free Trade Association -> organization, organisation, 
Eve Arden -> actress, 
Fatimid Caliphate -> Caliphate, 
Fermat's principle -> rationale, principle, 
Foreign relations of Burkina Faso -> relative, relation, 
Foreign relations of Eritrea -> coupling, mating, pairing, conjugation, union, sexual_union, 
Foreign relations of Mauritius -> sexual_intercourse, intercourse, sex_act, copulation, coitus, coition, sexual_congress, congress, sexual_relation, relation, carnal_knowledge, 
Foreign relations of Syria -> security, security_measures, 
Francesco Andreini -> actor, histrion, player, thespian, role_player, 
Francis II, Holy Roman Emperor -> Holy_Roman_Emperor, 
Fred Savage -> actor, doer, worker, 
GNU Compiler Collection -> system, 
GNU Octave -> high-level_language, 
Garage Inc. -> album, record_album, 
Gaspar Corte-Real -> explorer, adventurer, 
German literature -> text, textual_matter, 
Gilbert Cesbron -> novelist, 
Glitnir -> forsetus (not found in WordNet)
Goal line (American football) -> zone, 
Government of Sweden -> Sweden, Kingdom_of_Sweden, Sverige, 
Gramm-Latta Budget -> course_of_study, program, programme, curriculum, syllabus, 
Gregory of Tours -> tour, circuit, 
Guadalcanal Campaign -> campaign, military_campaign, 
Gumby -> figure, fig, 
Hannibal Hamlin -> state, province, 
Hans Dürer -> cougar, puma, catamount, mountain_lion, painter, panther, Felis_concolor, 
Heathers -> film, 
Hebrew numerals -> system, 
Heretics of Dune -> novel, 
History of Islam -> citizenry, people, 
History of Microsoft Windows -> window, 
Hollywood-style Lindy Hop -> style, 
House of Este -> este (not found in WordNet)
Hydroxyl ion absorption -> absorption, 
IA-32 -> microprocessor, 
Identity function -> function, purpose, role, use, 
Indo-Iranian languages -> terminology, nomenclature, language, 
Isaac Albéniz -> pianist, piano_player, 
Jacob Lawrence -> painter, 
James Spader -> actor, doer, worker, 
James White (author) -> novelette, novella, 
Jamiroquai -> funk, blue_funk, 
Java API for XML Processing -> api (not found in WordNet)
JavaServer Pages -> engineering, engineering_science, applied_science, technology, 
Jean Eugène Robert-Houdin -> magician, prestidigitator, conjurer, conjuror, illusionist, 
Jean-Claude Killy -> racer, race_car, racing_car, 
John Frederick, Margrave of Brandenburg-Ansbach -> founder, beginner, founding_father, father, 
John of Damascus -> barada (not found in WordNet)
Ken MacLeod -> writer, author, 
Kurfürstendamm -> avenue, boulevard, 
Labour Day -> holiday, 
Ladin language -> dialect, idiom, accent, 
Laetitia Casta -> model, role_model, 
LambdaMOO -> assortment, mixture, mixed_bag, miscellany, miscellanea, variety, salmagundi, smorgasbord, potpourri, motley, 
Lavr Kornilov -> secret_agent, intelligence_officer, intelligence_agent, operative, 
Lenny Bruce -> comedian, comic, 
Leopoldo Galtieri -> general, full_general, 
Lexus -> corporation, corp, 
Libertarian Party (United States) -> party, political_party, 
Library classification -> arrangement, organization, organisation, system, 
Linear polarization -> vector, 
Lisp machine -> computer, computing_machine, computing_device, data_processor, electronic_computer, information_processing_system, 
List of Russian language poets -> writer, author, 
List of The Sandman characters -> character, role, theatrical_role, part, persona, 
List of counties in Nebraska -> county, 
List of counties in New Hampshire -> county, 
List of political theorists -> theorist, theoretician, theorizer, theoriser, idealogue, 
List of woods -> forest, wood, woods, 
Lists of newspapers -> newspaper, paper, 
Llywelyn the Great -> gwynedd (not found in WordNet)
Local access and transport area -> term, 
Louis Andriessen -> composer, 
Louisiana Purchase Exposition -> exposition, 
Lumbar disc disease -> intervertebral_disc, intervertebral_disk, 
MAC address -> identifier, 
MOO (programming language) -> programming_language, programing_language, 
Mac OS X Server -> operating_system, OS, 
Madison, Wisconsin -> capital, working_capital, 
Malayo-Polynesian languages -> Austronesian, Austronesian_language, 
Malden Island -> island, 
Maluku Islands -> archipelago, 
Mancala -> board_game, 
Marc Bloch -> historian, historiographer, 
Mariner program -> plan, program, programme, 
Martina Hingis -> descent, 
Maximilian II, Holy Roman Emperor -> Bohemia, 
Mazda MX-5 -> layout, 
Meg Ryan -> actress, 
Mega- -> prefix, 
Mervyn Peake -> writer, 
Message format -> spatial (not found in WordNet)
Microsoft Excel -> application, practical_application, 
Mnemonic dominic system -> system, 
Monkey Island (series) -> June, 
Motala ström -> system, 
Motörhead -> rock_group, rock_band, 
Mulholland Drive (film) -> thriller, 
MultiMate -> word_processor, word_processing_system, 
Mötley Crüe -> ring, band, 
Nancy Sinatra -> singer, vocalist, vocalizer, vocaliser, 
Neper -> whole, unit, 
Neutral Moresnet -> condominium, condo, 
New York Jets -> football_team, eleven, 
Newcastle United F.C. -> clubhouse, club, 
Niger Armed Forces -> Niger, Niger_River, 
Notes on Muscovite Affairs -> book, volume, 
OSI model -> feat, effort, exploit, 
Obotrites -> tribe, federation_of_tribes, 
On War -> book, 
Organization for Security and Co-operation in Europe -> arrangement, organization, organisation, system, 
PackBits -> schema, scheme, 
Palatinate (region) -> region, part, 
Parable of the Pearl -> Jesus, Jesus_of_Nazareth, the_Nazarene, Jesus_Christ, Christ, Savior, Saviour, Good_Shepherd, Redeemer, Deliverer, 
Parma -> city, metropolis, urban_center, 
Paul Cézanne -> artist, creative_person, 
Paul Héroult -> furnace, 
Perth, Western Australia -> capital, 
Peter Guralnick -> music_critic, 
Phantom island -> island, 
Phil Ochs -> singer, vocalist, vocalizer, vocaliser, 
Pitch of brass instruments -> brass, brass_instrument, 
Platform game -> computer_game, video_game, 
Pneumatic tube -> system, 
Polish People's Party -> agrarian (not found in WordNet)
Politics of Chad -> place, station, 
Politics of Germany -> republic, 
Politics of Luxembourg -> space, blank_space, place, 
Politics of Saint Lucia -> place, 
Politics of Togo -> place, 
Politics of the Comoros -> place, 
Polyglotta Africana -> study, 
Pope Alexander II -> pope, Catholic_Pope, Roman_Catholic_Pope, pontiff, Holy_Father, Vicar_of_Christ, Bishop_of_Rome, 
Pope Alexander III -> pope, Catholic_Pope, Roman_Catholic_Pope, pontiff, Holy_Father, Vicar_of_Christ, Bishop_of_Rome, 
Pope Anacletus -> pope, Catholic_Pope, Roman_Catholic_Pope, pontiff, Holy_Father, Vicar_of_Christ, Bishop_of_Rome, 
Pope Anastasius IV -> Pope, Alexander_Pope, 
Pope Callixtus I -> pope, Catholic_Pope, Roman_Catholic_Pope, pontiff, Holy_Father, Vicar_of_Christ, Bishop_of_Rome, 
Pope Hyginus -> Rome, Roma, Eternal_City, Italian_capital, capital_of_Italy, 
Pope Innocent XII -> Pope, Alexander_Pope, 
Pope Stephen IX -> pope, Catholic_Pope, Roman_Catholic_Pope, pontiff, Holy_Father, Vicar_of_Christ, Bishop_of_Rome, 
Pope Urban I -> urban (not found in WordNet)
Pope Urban IV -> pope, Catholic_Pope, Roman_Catholic_Pope, pontiff, Holy_Father, Vicar_of_Christ, Bishop_of_Rome, 
Preliminary hearing -> proceeding, legal_proceeding, proceedings, 
Primary time standard -> standard, monetary_standard, 
Putnam County, Missouri -> citizenry, people, 
Quadrupedalism -> locomotion, motive_power, motivity, 
REO Speedwagon -> rock_group, rock_band, 
Radix sort -> integer, whole_number, 
Rail transport modelling -> railway, railroad, railroad_line, railway_line, railway_system, 
Rammstein -> set, circle, band, lot, 
Randolph (ship) -> vessel, vas, 
Rathaus Schöneberg -> city_hall, 
Reed–Solomon error correction -> code, computer_code, 
Referential transparency (computer science) -> program, programme, computer_program, computer_programme, 
Renate Groenewold -> speedskater, speed_skater, 
Render farm -> bunch, clump, cluster, clustering, 
Richard Myers -> general, full_general, 
Robert Dudley, 1st Earl of Leicester -> Lord, noble, nobleman, 
Rook (chess) -> man, piece, 
Rosie O'Donnell -> comedienne, 
Ruddigore -> comic_opera, opera_bouffe, bouffe, opera_comique, 
SNOBOL -> name, 
Salma Hayek -> actress, 
Sam Peckinpah -> film_maker, filmmaker, film_producer, movie_maker, 
Saturday Night Fever -> film, 
Scansano -> beginning, origin, root, rootage, source, 
Science and technology in Jamaica -> agenda, docket, schedule, 
Security through obscurity -> pejorative (not found in WordNet)
Segesta -> people, 
Semantic network -> network, electronic_network, 
Semiology (Gregorian Chant) -> research, 
Servius Tullius -> servius (not found in WordNet)
Sin (video game) -> shooter, 
Sinatra Doctrine -> name, 
Smoke signal -> communication, 
Social sciences -> scholarship, 
Soviet submarine K-8 -> fleet, 
Spaced repetition -> technique, 
Static program analysis -> software, software_program, computer_software, software_system, software_package, package, 
Stevie Nicks -> singer-songwriter (not found in WordNet)
Strategic Air Command -> department, section, 
TRS-80 Color Computer -> home_computer, 
Tatian -> century, 
Telephony Application Programming Interface -> Apus, 
The Broadway Melody -> film, 
The Concert in Central Park -> album, record_album, 
The Flying Dutchman (opera) -> opera, 
The Patchwork Girl of Oz -> novel, 
The Residents -> art, fine_art, 
The Wasp Factory -> novel, 
Thermal conductivity -> ability, 
Thomas Szasz -> psychiatrist, head-shrinker, shrink, 
Timothy McVeigh -> state, 
Tipu Sultan -> kingdom, land, realm, 
Tractor beam -> device, 
Transport in Eritrea -> conveyance, transport, 
Transportation in the Philippines -> Department_of_Transportation, Transportation, DoT, 
Triton (mythology) -> god, 
Tropospheric wave -> radio_wave, radio_emission, radio_radiation, 
Truro -> city, metropolis, urban_center, 
Turbomolecular pump -> air_pump, vacuum_pump, 
USS Monitor -> warship, war_vessel, combat_ship, 
USS Ohio -> name, 
Unified Modeling Language -> language, linguistic_communication, 
Unitary authority -> local_authority, 
United States presidential election, 1840 -> Harrison, Rex_Harrison, Sir_Rex_Harrison, Reginald_Carey_Harrison, 
United States presidential election, 1860 -> drift, impetus, impulsion, 
Urban design -> arrangement, 
Vannevar Bush Award -> prize, award, 
Vela (constellation) -> constellation, 
Verkhoyansk Range -> siberium (not found in WordNet)
Verlan -> slang, cant, jargon, lingo, argot, patois, vernacular, 
Vincent Alsop -> clergyman, reverend, man_of_the_cloth, 
Visby -> vicinity, locality, neighborhood, neighbourhood, neck_of_the_woods, 
Viva Villa! -> movie, film, picture, moving_picture, moving-picture_show, motion_picture, motion-picture_show, picture_show, pic, flick, 
Vladimir Arnold -> mathematician, 
Volunteer (botany) -> plant, works, industrial_plant, 
W3m -> beginning, origin, root, rootage, source, 
West Bromwich Albion F.C. -> clubhouse, club, 
Yoneda lemma -> solution, answer, result, resolution, solvent, 
Zeeland -> netherland (not found in WordNet)
Ziad Jarrah -> attack, onslaught, onset, onrush, 
Zion, Illinois -> city, metropolis, urban_center, 
Zoetrope -> device, gimmick, twist, 
Çevik Bir -> general_staff, 
