Ancient Egypt -> ancient_history, 
Amazing Grace -> hymn, anthem, 
Afonso V of Portugal -> 1481 deaths -> death, dying, demise, 
Albrecht Altdorfer -> cougar, puma, catamount, mountain_lion, painter, panther, Felis_concolor, 
Conservation-restoration -> profession, 
Au file format -> format, formatting, data_format, data_formatting, 
Aberdeen Bestiary -> Bestiaries -> bestiary, 
Black letter law -> Legal terms -> term, 
Blood on the Tracks -> album, record_album, 
Telecommunications in Brunei -> Communications in Brunei -> communication, communicating, 
Bobby Charlton -> football_player, footballer, 
Broadcast domain -> computer_network, 
Battle of the Nile -> naval_battle, 
Boeing 747 -> airliner, 
Battle of Bouvines -> Conflicts in 1214 -> conflict, 
Bistability -> phenomenon, 
Physical cosmology -> structure, 
Cult film -> deoxyadenosine_monophosphate, A, 
Chinese philosophy -> doctrine, philosophy, philosophical_system, school_of_thought, ism, 
Copenhagen interpretation -> machinist, mechanic, shop_mechanic, 
Christian Goldbach -> mathematician, 
Canes Venatici -> Western constellations -> constellation, 
Cimbri -> Ancient peoples -> people, 
Chrominance -> signal, 
Colorado Front Range -> Tourism regions of Colorado -> region, realm, 
European Conference of Postal and Telecommunications Administrations -> 1959 establishments -> establishment, 
Creation myth -> culture, 
Charles I of England -> Executed royalty -> royalty, royal_family, royal_line, royal_house, 
Charles Mingus -> Third Stream musicians -> musician, instrumentalist, player, 
History of the Dominican Republic -> History of Hispaniola -> history, 
DNA ligase -> enzyme, 
Daniel Dennett -> philosopher, 
David Bowie -> manufacturer, producer, 
Diesel multiple unit -> rolling_stock, 
Decca Navigator System -> system, 
Das Boot -> film, 
Distance education -> Educational technology -> engineering, engineering_science, applied_science, technology, 
Directed set -> Order theory -> theory, 
Evolutionary linguistics -> origin, origination, inception, 
Elizabeth Garrett Anderson -> English women in politics -> woman, 
Endoplasmic reticulum -> Organelles -> organelle, cell_organelle, cell_organ, 
Extra-vehicular activity -> Russian inventions -> invention, innovation, 
Emin Boztepe -> beginning, origin, root, rootage, source, 
Emsworth -> Towns in Hampshire -> town, 
Emperor Suizei -> Legendary Emperors of Japan -> emperor, 
Frisian languages -> Languages of Germany -> linguistic_process, language, 
Government of France -> Government of France -> government, authorities, regime, 
Formal language -> Formal languages -> terminology, nomenclature, language, 
Four Freedoms -> State of the Union addresses -> Department_of_State, United_States_Department_of_State, State_Department, State, DoS, 
Flamsteed designation -> Astronomical catalogues -> catalog, catalogue, 
Frankie Goes to Hollywood -> Music from Liverpool -> music, 
Fine Gael -> Political parties established in 1933 -> party, 
Economy of the Federated States of Micronesia -> Economy of the Federated States of Micronesia -> economy, saving, 
Fantasy film -> film, cinema, celluloid, 
Gulf Coast of the United States -> Gulf_of_Mexico, Golfo_de_Mexico, 
Foreign relations of Gabon -> policy, 
German Unity Day -> Germany, Federal_Republic_of_Germany, Deutschland, FRG, 
Gregory Chaitin -> mathematician, 
Economy of Guadeloupe -> Economy of Guadeloupe -> economy, thriftiness, 
Gothic fiction -> Horror genres -> music_genre, musical_genre, genre, musical_style, 
George Gordon, 1st Earl of Aberdeen -> People from Aberdeenshire -> people, 
Goshen, Indiana -> city, 
Charles Goren -> Jewish bridge players -> player, participant, 
Demographics of Hong Kong -> Demographics by city -> demographic, 
History of the Mediterranean region -> history, 
Hugo Gernsback -> Order of the Oak Crown recipients -> order, 
Harry Connick, Jr. -> Musicians from New Orleans, Louisiana -> musician, instrumentalist, player, 
Houston Texans -> football_team, eleven, 
List of kings of Persia -> Lists of monarchs -> list, listing, 
Harrison Narcotics Tax Act -> state, province, 
Indo-Iranian languages -> terminology, nomenclature, language, 
Intel -> Semiconductor companies -> company, 
Irssi -> Cross-platform software -> software, software_program, computer_software, software_system, software_package, package, 
IKEA -> company, 
ICQ -> iOS software -> software, software_program, computer_software, software_system, software_package, package, 
Demographics of Jordan -> Demographics of Jordan -> demographic, 
July 29 -> July, 
Juruá River -> International rivers of South America -> river, 
Jean Richard -> actor, histrion, player, thespian, role_player, 
Keanu Reeves -> actor, doer, worker, 
KL-ONE -> Ontology languages -> terminology, nomenclature, language, 
Calligra Words -> word_processor, word_processing_system, 
Linus Torvalds -> Finnish bloggers -> blogger, 
Demographics of Laos -> Laotian society -> society, 
Lazy evaluation -> Compiler optimizations -> optimization, optimisation, 
Looe Island -> island, 
Lamborghini -> Companies established in 1963 -> company, 
Lorenzo de' Medici -> statesman, solon, national_leader, 
Lynyrd Skynyrd -> rock_group, rock_band, 
Mälaren -> Norrström basin -> basin, 
Politics of the Republic of Macedonia -> republic, 
Military of Mauritania -> Military of Mauritania -> military, armed_forces, armed_services, military_machine, war_machine, 
Economy of Mauritius -> World Trade Organization member economies -> economy, 
Economy of Mexico -> Organisation for Economic Co-operation and Development member economies -> organization, organisation, 
Miyamoto Musashi -> fencer, swordsman, 
Mokele-mbembe -> Pygmy mythology -> mythology, 
March 11 -> march, marching, 
Mohamed Al-Fayed -> Fulham F.C. directors and chairmen -> conductor, music_director, director, 
Matilda of Tuscany -> Lady, noblewoman, peeress, 
Mehrgarh -> History of India -> history, 
Pointing device gesture -> mouse_button, 
Moctezuma II -> 1460s births -> birth, 
Mount Baker -> Active volcanoes -> volcano, 
Molokan -> Peace churches -> church, Christian_church, 
Nirvana (UK band) -> rock_group, rock_band, 
Telecommunications in Nauru -> radio_station, 
Communications on the Northern Mariana Islands -> Communications in the Northern Mariana Islands -> communication, communicating, 
Norma MacMillan -> actor, doer, worker, 
Nuremberg Trials -> Nuremberg, Nurnberg, 
Omri -> Israel, State_of_Israel, Yisrael, Zion, Sion, 
Telecommunications in the People's Republic of China -> industry, 
Economy of Paraguay -> Economy of Paraguay -> economy, 
Probability axioms -> probability_theory, theory_of_probability, 
Polymerase chain reaction -> technique, 
Pope Pius IV -> Pope, Alexander_Pope, 
Infant baptism -> baby, babe, infant, 
Porsche 944 -> sports_car, sport_car, 
Polyamory -> love, 
Pointless topology -> approach, approaching, coming, 
Pneumatic tube -> system, 
PA-RISC -> Instruction set architectures -> computer_architecture, architecture, 
Peenemünde Army Research Center -> 1937 establishments -> establishment, 
Robert Zubrin -> aerospace_engineer, 
Recreational drug use -> mental_health, 
Robert Nozick -> philosopher, 
Richard R. Ernst -> chemist, 
Rhythm guitar -> accompaniment, musical_accompaniment, backup, support, 
Saint Helena -> English-speaking countries and territories -> country, rural_area, 
Telecommunications in Saint Lucia -> Communications in Saint Lucia -> communication, communicating, 
Geography of Senegal -> prime_meridian, 
Transport in South Africa -> Transport in South Africa -> conveyance, transport, 
Military of Syria -> commanding_officer, commandant, commander, 
Statistical theory -> basis, base, foundation, fundament, groundwork, cornerstone, 
Saint Piran -> Medieval Cornish saints -> saint, 
Timeline for September following the September 11 attacks -> Aftermath of the September 11 attacks -> aftermath, wake, backwash, 
SMS -> Mobile telecommunications standards -> standard, criterion, measure, touchstone, 
Steve Jackson Games -> company, 
Smelt (fish) -> Osmeridae, family_Osmeridae, 
Security engineering -> security, security_measures, 
SECD machine -> machine, simple_machine, 
Stefan Banach -> Alumni of Lviv Polytechnic -> alumnus, alumna, alum, graduate, grad, 
The Time Machine -> Time travel novels -> novel, 
Texas Declaration of Independence -> Declarations of independence -> announcement, proclamation, annunciation, declaration, 
The Big Test -> History books about the United States -> book, volume, 
Telecommunications in Togo -> Communications in Togo -> communication, communicating, 
Tristan Bernard -> French journalists -> journalist, 
The Computer Contradictionary -> term, 
Tidal force -> graveness, gravity, sobriety, soberness, somberness, sombreness, 
Theoretical ecology -> science, scientific_discipline, 
Masaccio -> Tuscan painters -> painter, 
The Damned (band) -> set, circle, band, lot, 
Twiglets -> 1929 introductions -> introduction, 
Tomahawk (missile) -> Iraq War guided missiles -> projectile, missile, 
German Type II submarine -> World War II submarines of Germany -> submarine, pigboat, sub, U-boat, 
The Mythical Man-Month -> book, volume, 
The New Yorker -> Weekly magazines -> magazine, magazine_publisher, 
Tim Burton -> American music video directors -> conductor, music_director, director, 
The Avengers (TV series) -> ITV television programmes -> broadcast, program, programme, 
Germs (band) -> Musical quartets -> quartet, quartette, 
United Airlines Flight 175 -> World_Trade_Center, WTC, twin_towers, 
Uniramia -> Arthropods -> arthropod, 
Urban heat island -> area, expanse, surface_area, 
Telecommunications in Vanuatu -> Communications in Vanuatu -> communication, communicating, 
Video art -> artwork, art, graphics, nontextual_matter, 
Well-order -> order, purchase_order, 
Wulfstan of Hedeby -> 9th-century people -> people, 
WAV -> format, formatting, data_format, data_formatting, 
2nd millennium BC -> Millennia -> millennium, millenary, 
Christopher Tolkien -> Tolkien, J.R.R._Tolkien, John_Ronald_Reuel_Tolkien, 
Frederick Seitz -> American physicists -> physicist, 
Association for the Taxation of Financial Transactions and for Citizens' Action -> Think tanks based in France -> tank_car, tank, 
AAI RQ-7 Shadow -> United States military reconnaissance aircraft 1990-1999 -> Department_of_State, United_States_Department_of_State, State_Department, State, DoS, 
Shravanabelagola -> city, metropolis, urban_center, 
List of parasitic organisms -> Nature-related lists -> list, listing, 
Monopropellant rocket -> rocket, projectile, 
Valerian (herb) -> Valeriana, genus_Valeriana, 
Matthew of Kraków -> scholar, 
Actual infinity -> idea, 
Bi-curious -> term, 
Viceroyalty of New Granada -> States and territories established in 1717 -> state, nation, country, land, commonwealth, res_publica, body_politic, 
Rupert, King of Germany -> German kings -> king, 
Hanford Site -> complex, coordination_compound, 
Argumentum ad baculum -> argument, statement, 
Aloysius Lilius -> Italian astronomers -> astronomer, uranologist, stargazer, 
XYY syndrome -> sex_chromosome, 
Stephen Cook -> computer_scientist, 
Nottingham -> Local government in Nottinghamshire -> government, governing, governance, government_activity, administration, 
Luge at the 2002 Winter Olympics -> 2002 Winter Olympics events -> consequence, effect, outcome, result, event, issue, upshot, 
8th century BC -> Centuries -> century, 
Conjugate acid -> compound, chemical_compound, 
Richard M. Daley -> politician, 
Open Systems Interconnection -> IEC standards -> standard, criterion, measure, touchstone, 
Ivan Vidav -> mathematician, 
Buckingham Fountain -> Fountains in the United States -> fountain, 
United States presidential election, 1912 -> contest, competition, 
Marc Gagnon -> 1975 births -> birth, 
Bit slip -> spot, bit, 
Call collision -> thing, 
Connections per circuit hour -> meaning, significance, signification, import, 
Data compaction -> Data compression -> compression, 
Degree of start-stop distortion -> Telecommunications terms -> term, 
Inductive coupling -> Electromagnetic compatibility -> compatibility, 
Information-transfer transaction -> Telecommunications terms -> term, 
One-way trunk -> center, 
Masovian Voivodeship -> state, province, 
Variable-length buffer -> buffer, buffer_storage, buffer_store, 
Accuracy and precision -> quantity, 
Intensity (physics) -> flux, 
Everleigh Club -> whorehouse, brothel, bordello, bagnio, house_of_prostitution, house_of_ill_repute, bawdyhouse, cathouse, sporting_house, 
Kama Sutra -> text, 
Sandra Day O'Connor -> judge, justice, jurist, 
One Thousand and One Nights -> narrative, narration, story, tale, 
Gales Brewery -> Defunct brewery companies of the United Kingdom -> company, 
De facto -> saying, expression, locution, 
Eddie Blazonczyk -> Grammy Award winners -> achiever, winner, success, succeeder, 
John Coughlin (alderman) -> 1938 deaths -> death, 
United States Secretary of Education -> education, instruction, teaching, pedagogy, didactics, educational_activity, 
Amélie -> film, 
Ulugh Beg -> Scientific instrument makers -> maker, shaper, 
Congress of Vienna -> Department_of_State, United_States_Department_of_State, State_Department, State, DoS, 
Protected areas of South Africa -> geographical_area, geographic_area, geographical_region, geographic_region, 
Battle of Stirling Bridge -> Conflicts in 1297 -> conflict, 
Qattara Depression -> basin, 
Vecchio -> Vecchio class characters -> character, 
United States Secretary of Housing and Urban Development -> development, 
Emperor Go-Daigo -> Japanese emperors -> emperor, 
Drum machine -> Drum machines -> machine, 
Omaha, Nebraska -> city, 
La Caletta -> Cities and towns in Sardinia -> city, metropolis, 
Peering -> network, 
Fishbourne Roman Palace -> Buildings and structures in West Sussex -> building, 
Viral license -> term, 
Lipari -> island, 
Atlas (mythology) -> Greek_deity, 
Atlas (architecture) -> support, 
British Aerospace -> Aerospace companies of the United Kingdom -> company, 
19th century BC -> century, 
Bitch (insult) -> profanity, 
Semidirect product -> way, 
Denver and Rio Grande Western Railroad -> Defunct Utah railroads -> railroad_track, railroad, railway, 
Respiratory therapy -> field, field_of_operation, line_of_business, 
Advanced Maryland Automatic Network Disk Archiver -> Storage software -> software, software_program, computer_software, software_system, software_package, package, 
Eventing -> Military sports -> fun, play, sport, 
Airspeed Ltd. -> Companies based in York -> company, 
College Bowl -> run, ladder, ravel, 
Volunteer (botany) -> plant, works, industrial_plant, 
Emil Nolde -> expressionism, 
La Marseillaise -> Songs of the French Revolution -> birdcall, call, birdsong, song, 
Prosecutor's fallacy -> Logical fallacies -> fallacy, false_belief, 
Gian Galeazzo Visconti -> House of Visconti -> theater, theatre, house, 
Lelystad -> municipality, 
Hymenophore -> mycology, 
Robber baron -> name, 
Brahmic family of scripts -> orthography, writing_system, 
History of Russia (1992–present) -> country, rural_area, 
Irish dance -> form, variant, strain, var., 
Survivor: Marquesas -> state, province, 
Pan frying -> form, shape, pattern, 
Cervical cancer -> uterus, womb, 
William F. Nolan -> writer, author, 
The Moon Is a Harsh Mistress -> 1960s science fiction novels -> novel, 
United States Department of the Treasury -> Ministries established in 1789 -> ministry, 
Amung people -> Papua, 
Quantum Leap (TV series) -> series, 
Willie Rushton -> cartoonist, 
SIMD -> computer, computing_machine, computing_device, data_processor, electronic_computer, information_processing_system, 
Theoretical linguistics -> linguistics, 
Act Prohibiting Importation of Slaves -> state, province, 
Morrill Tariff -> 36th United States Congress -> state, nation, country, land, commonwealth, res_publica, body_politic, 
Federal Farm Loan Act -> Presidency of Woodrow Wilson -> presidency, presidential_term, administration, 
Farm Credit Administration -> politics, political_science, government, 
Ouagadougou -> Capitals in Africa -> capital, 
Penrose triangle -> object, 
Frances Burney -> British child writers -> writer, author, 
Putnam County, Illinois -> Putnam County, Illinois -> county, 
Jean Claude Eugène Péclet -> physicist, 
Clay County, North Carolina -> North Carolina counties -> county, 
Montgomery County, Virginia -> Montgomery County, Virginia -> county, 
Quechan people -> Federally recognized tribes in the United States -> tribe, federation_of_tribes, 
Hmong people -> Hmong, Miao, 
Opera Australia -> opera_company, 
Back River -> river, 
Charente-Maritime -> department, 
Dida language -> Languages of Côte d'Ivoire -> linguistic_process, language, 
GE-600 series -> mainframe, mainframe_computer, 
Timeline of rocket and missile technology -> rocket, projectile, 
Timeline of electromagnetism and classical optics -> optics, 
Timeline of states of matter and phase transitions -> Physics timelines -> timeline, 
Joseph Bonanno -> Bonanno crime family -> kin, kinsperson, family, 
Gold Coast, Queensland -> Seaside resorts in Australia -> haunt, hangout, resort, repair, stamping_ground, 
Initial and terminal objects -> Objects (category theory) -> object, 
Syriac language -> Aramaic, 
Charles Bukowski -> poet, 
The Number of the Beast (novel) -> novel, 
The Green Hills of Earth (short story collection) -> science_fiction, 
Albert I of Belgium -> Roman Catholic monarchs -> sovereign, crowned_head, monarch, 
Asynchronous Balanced Mode -> protocol, communications_protocol, 
Reginald Bretnor -> 1992 deaths -> death, 
Timişoara -> city, metropolis, urban_center, 
Georges Carpentier -> boxer, pugilist, 
